able	accountable, actable, abominable, admirable, advisable, affable, adorable, adaptable, acceptable, actionable
aeon	aegaeon, actaeon
ally	actually, aesthetically
ance	absorptance, acceptance, accordance, advance, acquittance, abundance, abeyance, acquaintance, absorbance, acutance, affiance, admittance
ancy	accountancy, aeromancy, adiathermancy
aria	adversaria, adularia
ated	addlepated, abbreviated
atic	adiabatic, aerostatic, adriatic, achromatic, acrobatic
ator	accumulator, aerator, administrator, accelerator, activator
bate	acerbate, adsorbate
bent	accumbent, absorbent, adsorbent
cate	adjudicate, affricate, abdicate, advocate
cent	adjacent, acescent, accent, adolescent, acquiescent, acaulescent, accrescent, abducent
cess	abscess, access
cian	academician, acoustician
cide	aborticide, acaricide
cism	academicism, aestheticism
cted	abstracted, affected, addicted
ctor	abductor, adductor
dant	abundant, accordant, abradant
ding	according, abiding
dity	absurdity, acidity
duce	adduce, abduce
duct	abduct, adduct
edly	advisedly, admittedly
ence	abhorrence, advertence, affluence, accidence, acquiescence, adherence, adolescence, absence, abstinence
eous	achlamydeous, acanthaceous, advantageous, aeneous
etal	acetal, acropetal
eter	aerometer, acidimeter, acetometer, accelerometer, actinometer
etic	abiogenetic, acetic, aesthetic
etry	aerometry, acidimetry
fect	aftereffect, affect
form	acinaciform, actiniform, aeriform, aciniform
gate	abnegate, abrogate
here	aerosphere, adhere
iate	affiliate, abbreviate, abranchiate
ible	admissible, accessible
ient	absorbefacient, abortifacient
inal	aboriginal, affinal, abdominal, actinal
ined	affined, addlebrained
inia	actinia, abyssinia
ious	adventitious, acrimonious, adscititious, abstemious
ival	adjectival, aestival
jure	adjure, abjure
late	aciculate, ablate, accumulate, acidulate, absquatulate, acetylate, adulate
lene	abilene, acetylene
lian	aeolian, abbevillian
lide	acetylide, acetanilide
line	adrenaline, acetylcholine
lish	accomplish, abolish
lite	aerolite, actinolite
lity	abnormality, ability, actuality
logy	aerology, acarology, aetiology, aerobiology, actinology
lous	acephalous, acidulous, adactylous, achelous
ment	adjustment, advertisement, abutment, accouterment, accouchement, abridgment, accouplement, additament, acknowledgment, advancement, adornment, acquirement, admeasurement, abatement, accompaniment, achievement, adjournment, advisement, accomplishment
mics	aerodynamics, aerothermodynamics
mite	adamite, termite
nate	abominate, adnate, affectionate, acuminate
nced	affianced, advanced
nder	afrikander, africander
ning	adjoining, aborning, afterburning
nism	abstractionism, actinism
nist	abstractionist, abortionist, accompanist, africanist
nium	actinium, actinouranium
noid	adenoid, actinoid
noma	adenoma, adenocarcinoma
oach	abroach, accroach
oard	aboveboard, aboard
obia	acrophobia, aerophobia
olis	aeolis, acropolis
onal	affectional, additional
oned	abandoned, aforementioned
onic	adonic, aaronic
opic	aeolotropic, adrenocorticotropic
osis	actinomycosis, acidosis, aeroneurosis, aerobiosis, abiosis
ound	aboveground, abound
pous	acrocarpous, acarpous
pted	adopted, accepted
pter	accepter, adapter
rant	adulterant, aberrant, accelerant
raph	addressograph, aerograph, aerometeorograph
rate	accelerate, administrate, acerate, acierate, adulterate, acculturate, accurate, adumbrate, aerate
rent	afferent, adherent, abhorrent
ress	adventuress, adulteress, actress, address
rial	accusatorial, aerial
rian	adrian, abecedarian
rile	afebrile, acrylonitrile
rine	adulterine, aeromarine, accipitrine
rism	adiaphorism, adventurism
rome	aerodrome, acrodrome
rous	adiaphorous, adventurous, adulterous
sary	accessary, adversary
sion	abrasion, abscission, adhesion, admission, accession, affusion
sive	abessive, abusive, admissive, adhesive, adessive, abrasive
sorb	absorb, adsorb
sory	advisory, accessory
stic	acoustic, acrostic
tant	acceptant, accountant, abirritant, adjutant
tate	acetate, abirritate
thus	acanthus, aegisthus
tics	aerostatics, acrobatics, aesthetics, aerodonetics, aeroballistics, acoustics, aerobatics, aerotherapeutics, aeronautics
time	teatime, aftertime, aforetime
ting	accounting, abutting, affecting, accommodating, acting
tion	action, abruption, acculturation, adaptation, addiction, abomination, abstriction, acclamation, accumulation, ablation, acquisition, accretion, absolution, affirmation, abreaction, aberration, aerification, abstention, adjudication, addition, abortion, affiliation, affliction, abjuration, abduction, admonition, adulteration, affixation, aerostation, administration, advection, accentuation, admiration, acceptation, affectation, accusation, adscription, adoration, abolition, aestivation, adulation, adjunction, absorption, acceleration, aftersensation, accommodation, adduction, abdication, ablution, ademption, abstraction, affection, advocation, abbreviation
tism	achromatism, absolutism
tive	affirmative, adjective, abortive, active, additive, addictive, afflictive, adversative, accusative, ablative, accumulative, acquisitive, affricative, affinitive, affective, adoptive, adaptive, administrative, accommodative
tize	acclimatize, achromatize
tomy	adenoidectomy, adenectomy
tory	accusatory, additory, admonitory, affirmatory
tous	achromatous, acetous
ttal	acquittal, abuttal
tter	aflutter, abutter
tual	accentual, actual
ture	admixture, adventure, acupuncture
uate	actuate, accentuate, adequate, acuate
ught	aforethought, afterthought
ulia	aboulia, abulia
ulum	aciculum, acetabulum
vate	acervate, aestivate, activate
vity	acclivity, activity, absorptivity
xial	abaxial, adaxial
